9WWWW99WWWWW
WW00W99W000W
W0B0WWWWB00W
W00BFFFF0B0W
WW0000W0S0WW
9WWWWWWWWWW9