9WWWWW99
9W0SWWW9
9W0B00F9
WWW0W0WW
WFW0W00W
WFB00W0W
WF000B0W
WWWWWWWW