9WWWWWWWWW9
9W00WW000W9
9W000B000W9
9WB0WWW0BW9
9W0WFFFW0W9
WW0WFFFW0WW
W0B00B00B0W
W00000W00SW
WWWWWWWWWWW
99999999999