99WWWWW9
WWW00SW9
W00BF0WW
W00FBF0W
WWW0RB0W
99W000WW
99WWWWW9