99WWWW99
99WFFW99
9WW0FWW9
9W00BFW9
WW0B00WW
W00WBB0W
W00S000W
WWWWWWWW