9WWWWWWW99
9W00000WWW
WWBWWW000W
W0S0B00B0W
W0FFW0B0WW
WWFFW000W9
9WWWWWWWW9